01000100
01100101
01110011
01100101
01110010
01110101
01101110
01110100
00100000
01110011
01110101
01101110
01110100
00100000
01101110
01101111
01101110
00100000
01101100
01100001
01100010
01101111
01110010
01101001
01110011
00100000
01101001
01110010
01110101
01110010
01100101
00100000
01100011
01110101
01110000
01101001
01100100
01100001
01110100
01100001
01110100
00100000
01100100
01101111
00100000
01101100
01100001
01100010
01101111
01110010
01110101
01101101
00100000
01100101
01110011
01110011
01100101
00100000
01110011
01101001
01110100
00101110
00100000
01010011
01101001
01101110
01110100
00100000
01101100
01100001
01100010
01101111
01110010
01100101
00100000
01100100
01101111
01101100
01101111
01110010
01100101
00100000
01110000
01100001
01110010
01101001
01100001
01110100
01110101
01110010
00100000
01110011
01101001
01101110
01110100
00100000
01101001
01110010
01110101
01110010
