01000100
01000101
00100000
01001100
01010101
01001110
01000101
01010011
00100000
01000001
00100000
01000100
01001111
01001101
01001001
01001110
01000111
01001111
00100000
01010110
01001111
01011001
00100000
01000100
01000101
01010011
01000101
01010011
01010000
01000101
01010010
01000001
01000100
01001111
00100000
01000101
01001100
00100000
01000011
01001111
01010010
01000001
01011010
01001111
01001110
00100000
01010000
01010010
01000101
01001110
01000100
01001001
01000100
01001111
00100000
01000001
01001100
01001100
01001001
00100000
01000101
01001110
00100000
01000101
01001100
00100000
01000011
01000001
01001100
01000101
01001110
01000100
01000001
01010010
01001001
01001111
00100000
01000010
01010101
01010011
01000011
01000001
01001110
01000100
01001111
01010100
01000101
00100000
01011001
00100000
01000010
01010101
01010011
01000011
01000001
01001110
01000100
01001111
00100000
00000000