001000010000000000001010
010100010010001100000000
011001010110011100000000
101000000010001100000000
101100000000000000000110
001010100000000011001000
001110111100000000000000
000000000000000000000000