0000010001111101
0000000111010010
0000100011001110
0000010110101000
0000001001101011
0000100000000101
0000000111010010
0000010010110101
0000100011001110
0000100010010011
0000100011001110
0000010001111101
0000011000101100
0000010110110101
0000000010101011
0000100000000101
0000001010111101
0000011000101100
0000100011001110
0000001010011010
0000011000101100
0000011101110000
0000100011001110
0000010001111101
0000000111010010
0000010010110101
0000000111010010
0000010010110101
0000100010100101
0000000111010010
0000010111000011
0000100010010011
0000010001111101
0000011000101100
0000100011001110
0000000111010010
0000010110101000
0000100011001110
0000000110111001
0000011000101100
0000010111000011
0000100010010011
0000011001010000
0000011000101100
0000100000000101
0000100011001110
0000100010100101
0000010111000011
0000000111010010
0000100000000101
0000010001111101
0000000010101011
0000010001111101
0000011000101100
0000100011001110
0000100010010011
0000010110101000
0000010110101000
0000000010101011
0000100011001110
0000000111010010
0000100000000101
0000100011001110
0000000111010010
0000010110101000
0000100011001110
0000000110111001
0000100010010011
0000010110101000
0000000111010010
0000100000000101
0000010001111101
0000100010010011
0000010111000011
0000000010101011
0000011000101100
0000100011001110
0000010101000101
0000001001101011
0000010010110101
0000000110111001
0000100010010011
0000100000000101
0000010001111101
0000011000101100
0000000001011111
0000000111010010
0000100011001110
0000011101110000
0000100011001110
0000010101000101
0000001001101011
0000010010110101
0000000110111001
0000100010010011
0000100000000101
0000010001111101
0000011000101100
0000100011001110
0000000110111001
0000000110000101
0000100011110011
