0000101111001000
0000111000011100
0001011010110000
0000111000011100
0000111010010110
0000010010010010
0000001000100000
0000100101100000
0001000111111110
0001011010110000
0000010010010010
0000001000100000
0000100101100000
0001000111111110
0000001000100000
0001001100010111
0000001000100000
0001000111111110
0000010101011000
0000100100001100
0001000001111111
0001001100010111
0000111010010110
0000001000110110
0001011010110000
0001000111111110
0000001000110110
0000111010010110
0000010010010010
0000111010010110
0000111000011100
0001000111111110
0001010000010110
0000010010010010
0000111100010110
0000001000110110
0001000010000011
0000100100001100
0000100101100000
0000100100001100
0000100101100000
0001000111111110
0001000010000011
0001001100010111
0001000111111110
0000010101011000
0000100100001100
0001000001111111
0001001100010111
0000111010010110
0000010010010010
0000011010111111
0001000111111110
0000111000011100
0001011010110000
0001011010110000
0000111000011100
0001000111111110
0001011010110000
0000001000110110
0000100101100000
0000010010011111
0001000111111110
0000011010101110
0000001000110110
0000001000100000
0000100101100000
0001000111111110
0000010101011000
0000100100001100
0001000001111111
0001001100010111
0000111010010110
0000111000011100
0001000111111110
0001000010000011
0001001100010111
0000010101011000
0001001100010111
0000111010010110
0000111000011100
0001000111111110
0000111100010110
0000100100001100
0000111010010110
0000001000110110
0000100100001100
0000100101100000
0000010010010010
0000111010010110
0001000111111110
0001011010110000
0000001000110110
0000001000100000
0000100101100000
0001000111111110
0000001000110110
0000111010010110
0000010010010010
0000111010010110
