0000001100110111
0000001100110111
0000001100110111
0000001100110111
0000001100110111
0000001100110111
0000001110101001
0000001110101001
0000001110101001
0000001110101001
0000001110101001
0000001110101001
0000111110110100
0000111110110100
0000111110110100
0000111110110100
0000111110110100
0000111110110100
0000011100010010
0000011100010010
0000011100010010
0000011100010010
0000011100010010
0000011100010010
0001000001101010
0001000001101010
0001000001101010
0001000001101010
0001000001101010
0001000001101010
0000110001111010
0000110001111010
0000110001111010
0000110001111010
0000110001111010
0000110001111010
0000101100011000
0000101100011000
0000101100011000
0000101100011000
0000101100011000
0000101100011000
0000101100011001
0000101100011001
0000101100011001
0000101100011001
0000101100011001
0000101100011001
0000011010011011
0000011010011011
0000011010011011
0000011010011011
0000011010011011
0000011010011011
0000100101001011
0000100101001011
0000100101001011
0000100101001011
0000100101001011
0000100101001011
0000111100010101
0000111100010101
0000111100010101
0000111100010101
0000111100010101
0000111100010101
0000011010011010
0000011010011010
0000011010011010
0000011010011010
0000011010011010
0000011010011010
0000100011111101
0000100011111101
0000100011111101
0000100011111101
0000100011111101
0000100011111101
0000110110000111
0000110110000111
0000110110000111
0000110110000111
0000110110000111
0000110110000111
0000111111010011
0000111111010011
0000111111010011
0000111111010011
0000111111010011
0000111111010011
0000101000001110
0000101000001110
0000101000001110
0000101000001110
0000101000001110
0000101000001110
0001000110100001
0001000110100001
0001000110100001
0001000110100001